13
31
###############################
#p     ** *  1 * * *  * * *   #
# # # #*# # #*#*# # # #*#*#*# #
#  x*     ***  *  1   * 2 * * #
# # # # # #*# # #*#*# # # # #*#
#f         1 *b  *  *         #
# # # # # # # # # #*# #*# # # #
#*  *      *  *   2  *        #
# # # # #*# # # #*#*# # # # # #
#*    **  *       *           #
# #*# # # # # # #*# # # # # # #
#           *   *  *          #
###############################