13
31
###############################
#p     s* *  1 *   *  * * *   #
# # # #*# # #*#*# # # #*#*# # #
#  x*     b**  *      **    * #
# # # # # #*# # #*#*# # # # #*#
#f         x **  2  *         #
# # # # # # # # # #*# #*# # # #
#*  *      *  *      *        #
# # # # #1#*# # #*#*# # # # # #
#*    **  *             *     #
# #*# # # # # # #*# # # # # # #
#     * 1       *  *       *  #
###############################