13
31
###############################
#p     s* *  1 *   *  * * *   #
# # # #*# # #*#*# # # #*#*# # #
#  x*     b**  *      *3    * #
# # # # # #*# # #*#*# # # # #*#
#f         x **  2  *         #
# # # # # # # # # #*# #*# # # #
#*  *      *  *      *        #
# # # # #1#*# # #*#*# # # # # #
#*    **  *             *     #
# #*# # # # # # #*# # # # # # #
#     * 1       *  *       2  #
###############################