13
31
###############################
#p * *2       *  *f * *      *#
# # # # #*# # #*# # # # # #*# #
#    * * *** **      *    3*  #
# #*# # # # #1# #b#1# # # # #*#
#          *     **      *  **#
# # #*#s# # # # #*#*#*#*# # # #
#   *        *   * *x* *      #
# # # # #*# # # # # # #*# #*# #
#   3***         *1           #
# # # # # # # # # #*# # # # #*#
#  ** *   *    3          2   #
###############################